GPSSPRGGGGGTTTGGGGGGTTTGTTGGGGGGTTTGTGGGGGGGTTGGGGGGGGRPSSPG
PPSSPCPPPPPPPPPPPPPPPPPPPPPPPPPPPPPPPPPPPPPPPPPPPPPPPPCPSSPP
SSSSSXSSSSSSSSSSSSSSSSSSSSSSZSSZSSSSSSSSSSSSSSSSSSSSSSXSSSSS
SSSSSXSSSSSSSSSSSSSSSSSSSSSSZSSZSSSSSSSSSSSSSSSSSSSSSSXSSSSS
PPSSPCPZZPPPPPPPPPPPPPPPPPPPPSSPPPPPPPPPPPPPPPPPPPPZZPCPSSPP
RCXXCRCXXCRRRRRRRRRRRRRRRRRRCXXCRRRRRRRRRRRRRRRRRRCXXCRCXXCR
TPSSPRPSSPPPPPPPPPPPPPPPPPPPPSSPPPPPPPPPPPPPPPPPPPPSSPRPSSPG
TPSSPRPSSSSSSSSZSSZSSSSSSSSSSSSSSSSSSSSSSSSSSSSSSSSSSPRPSSPG
GPSSPRPSSSSSSSSZSSZSSSSSSSSSSSSSSSSSSSSSSSSSSSSSSSSSSPRPSSPT
TPSSPRPSSPPPPPPPSSPPPPPPPPPPPPPPPPPPPPPPPPPPPPPPPPPSSPRPSSPG
TPSSPRPSSSPPTBBPSSPGTGGGBBBBBGPPPPPPPPGTBBBBBBGBBPSSSPRPSSPG
GPSSPRPSSSSPPTBPSSPTTTPPPPPPPPPSSSSSSPPPBBBBBBGBBPSGSPRPSSPT
GPSSPRPPSSSSPPTPSSPGTGPSSSSSSSSSSSSSSSSPPPGTTPPPPPSGSPRPSSPT
GPSSPRGPPSSSSPPPSSPPBBPSSSSSSSSSSPPSSSSSSPPPGPSSSSSGSPRPSSPG
TPSSPRGGPPSSSSPSSSSPPPPSSPSSPPSSPPPPPSSSSSSPPPSSSSSSSPRPSSPG
TPSSPRGGGPPSSSSSBBSSSSSSSSSSPPSSSSSSPPPSSSSSSZSSPPPPPPRPSSPT
GPSSPRGGGGPPSSSSBBSSSSSSSSSSPPSPPPPSSSPPPSSSSZSSPPSSPGRPSSPT
TPSSPRGGGGGPPPPSSSSPPPPPPPPPPPSPPSSSSSSPPPPPPPSSPPSSPTRPSSPG
GPSSPRGGGGGGGGPPSSPPSSSSSSSSGPSSSSPPSSSSPPGTGPSSSSSSPTRPSSPG
GPSSPRGGGGGBBBGPSSSSSSSSSSSSSPPPPPPPPSSSSPPGPPSSSSSSPTRPSSPG
GPSSPRGGGGGBBBGPSSSSSSPPPPSSSSSSSSSSPPSSSSPPPSSSPPPPPTRPSSPT
GPSSPRGGGGGBBBGPSSPPPPPGGPPSSSSSSSSSSPPSSSSPSSSSPBBBBTRPSSPG
GPSSPRPPPPPPPPPPSSPGGTTTTTPPPPPPPPSSSSPPSSSSSSSPPBBBBBRPSSPG
GPSSPRPSSSSSSSSSSSPGGTGGGTTTTGBBGPPSSSSPPSSSSSPPGGGGGTRPSSPG
TPSSPRPSSSSSSSSSSSPGGTTBGTTTTTBBTGPPSSSSPPPPSSSPPPPPPTRPSSPG
TPSSPRPSSPPPPPPPSSPGGTTGGTTGGTGTTTGPPSSSSSSPSSSSSSSSPGRPSSPT
TPSSPRPSSPBGBBBPSSPGGTTGTTTGGPPPPTGGPPSSSSSPPSSSSSSSPGRPSSPT
TPSSPRPSSPBGBBBPSSPGGGGGGGGGPPSSPPGGGPPPPPPPPPPPPPZZPPRPSSPG
GPZZPCPZZPPPPPPPSSPPPPPPPPPPPSSSSPPPPPPPPPPPPPPPPSSSSPCPZZPG
GPSSSXSSSSSSSSSSSSSSSSSSSSSSSSBBSSSSSSSSSSSSSSSSSSBBSSXSSSPT
GPSSSXSSSSSSSSSSSSSSSSSSSSSSSSBBSSSSSSSSSSSSSSSSSSBBSSXSSSPT
GPZZPCPPPPPPPPPPPPPPSSPPPPPPPSSSSPPPPPPPSSPPPPPPPSSSSPCPZZPG
GPSSPRPSSSSPPBBBBPPSSSPGGPPPPPSSPPPPPGGPSSSPPGBBPPSSPPRPSSPT
TPSSPRPSSSSSPBBBBPSSSSPBBPSSSSSSSSSSPGGPSSSSPGBBGPSSPTRPSSPT
TPSSPRPPPSSSPGGGGPSSSPPGGPSSSSSSSSSSPGTPPSSSPTGTGPSSPTRPSSPG
TPSSPRTTPPSSPGTTGPSSPPTTGPSSPPPPPPSSPGTGPPSSPGTTGPSSPTRPSSPG
GPSSPRGBBPSSPGTTTPSSPGTTBPSSPGGGTPSSPGTTGPSSPGTTTPSSPGRPSSPG
GPSSPRGBBPSSPGTTTPSSPGBBBPSSPGGTTPSSPGGGGPSSPGGTTPSSPGRPSSPG
TPSSPRPPPPSSPPPPPPZZPPPPPPZZPPPPPPSSPPPPPPZZPPPPPPZZPPRPSSPG
TPSSPRPSSSSSSSSSSSSSSSSSSSSSSSSSSSSSSSSSSZSSZSSSSSSSSPRPSSPG
GPSSPRPSSSSSSSSSSSSSSSSSSSSSSSSSSSSSSSSSSZSSZSSSSSSSSPRPSSPG
GPSSPRPSSPPPPPSSPPPPPPPPPPPPZZPPPPPZZPPPPPSSPPPPPSSPPPRPSSPG
GPSSPRPSSPTTGPSSPGGGTTTGBBBPSSPGTTPSSPBBGPSSPGBBPSSPBGRPSSPT
GPSSPRPSSPGGGPSSPGGGGTTGBBBPSSPGTGPSSPBBTPSSPTBBPSSPBTRPSSPT
GPSSPRPSSPPPPPZZPPPPPPPPPPPPSSPPPPPSSPPPPPSSPPPPPSSPPGRPSSPG
GPSSPRPSSSSSSZSSZSSSSSSSSSSSSSSSSSSSSSSSSSSSSSSSSSSSPGRPSSPG
GPSSPRPSSSSSSZSSZSSSSSSSSSSSSSSSSSSSSSSSSSSSSSSSSSSSPTRPSSPT
TPSSPRPPSSPPPPZZPPPPSSPPPPZZPPPPSSPPPPPPPPPPSSPPPPZZPTRPSSPG
TPSSPRGPSSPBBPSSPBBPSSPGBPSSPBGPSSPGTTTGGGGPSSPGTPSSPGRPSSPT
TPSSPRGPSSPBBPSSPBBPSSPBBPSSPBGPSSPTTTTGTTGPSSPGGPSSPGRPSSPG
GPSSPRGPSSPPPPSSPPPPZZPPPPSSPPPPZZPPPPPPPPPPZZPPPPSSPTRPSSPT
GPSSPRTPSSSSSSSSSSSSSSSSSSSSSSSSSSSSSSSSSSSSSSSSSSPPPGRPSSPG
GPSSPRTPSSSSSSSSSSSSSSSSSSSSSSSSSSSSSSSSSSSSSSSSSSPGGTRPSSPG
GPSSPRTPPPPPPPPPPPPPPPPPPPPPPSSPPPPPPPPPPPPPPPPPPPPGTTRPSSPG
RCXXCRRRRRRRRRRRRRRRRRRRRRRRCXXCRRRRRRRRRRRRRRRRRRRRRRRCXXCR
PPSSPCPPPPPPPPPPPPPPPPPPPPPPPSSPPPPPPPPPPPPPPPPPPPPPPPCPSSPP
SSSSZXSSSSSSSSSSSSSSSSSSSSSSSSSSSSSSSSSSSSSSSSSSSSSSSSXZSSSS
SSSSZXSSSSSSSSSSSSSSSSSSSSSSSSSSSSSSSSSSSSSSSSSSSSSSSSXZSSSS
PPSSPCPPPPPPPPPPPPPPPPPPPPPPPPPPPPPPPPPPPPPPPPPPPPPPPPCPSSPP
GPSSPRGGGGTTGGGTGGGGGGTTGGGGGGGGGGGTTGGGGGTGGTTGGGTTGGRPSSPG